###########
#.@.......#
#.........#
#.........#
#.........#
#.........#
#.........#
#.........#
#.........#
#.........#
###########