###########
#.@.......#
#......#..#
#......#..#
#......#..#
#.........#
#...####..#
#...#.....#
#...#.....#
#.........#
###########