############
#.@........#
#..........#
#..........#
#..........#
#..........#
#..........#
#..........#
#..........#
#..........#
#..........#
############