############
#....@.....#
#..........#
#..........#
#..........#
#..........#
#..........#
#..........#
#..........#
#..........#
#..........#
############