############
#.@........#
#.....##...#
#......#...#
#......#...#
#..........#
#...####...#
#...#......#
#...#......#
#..........#
#..........#
############